00000000000000000000000000000
02111111111110001111111111120
01000010000010001000001000010
01000010000010001000001000010
01000010000010001000001000010
01111111111111111111111111110
01000010010000000001001000010
01000010010000000001001000010
02111110011110001111001111120
00000010000010001000001000000
00000010000010001000001000000
00000010011111p11111001000000
00000010010000w00001001000000
00000010010a_b_c_d01001000000
11111111110000000001111111111
00000010011111111111001000000
00000010010000000001001000000
00000010011111111111001000000
00000010000010001000001000000
00000010000010001000001000000
02111110011110001111001111120
01000010010000000001001000010
01000010010000000001001000010
01111111111111111111111111110
01000010000010001000001000010
01000010000010001000001000010
01000010000010001000001000010
02111111111110001111111111120
00000000000000000000000000000