0000000000000000000000000000
0211111111111001111111111120
0100001000001001000001000010
0100001000001001000001000010
0100001000001001000001000010
0111111111111111111111111110
0100001001000000001001000010
0100001001000000001001000010
0211111001111001111001111120
0000001000001001000001000000
0000001000001001000001000000
0000001001111111111001000000
0000001001000==0001001000000
00000010010______01001000000
11111111110b_p_ic01111111111
00000010010______01001000000
0000001001000000001001000000
0000001001111111111001000000
0000001000001001000001000000
0000001000001001000001000000
0211111001111001111001111120
0100001001000000001001000010
0100001001000000001001000010
0111111111111111111111111110
0100001000001001000001000010
0100001000001001000001000010
0100001000001001000001000010
0211111111111001111111111120
0000000000000000000000000000